{
    "airport": "EGKK",
    "grid": [
        ["5", "2", "3", "2", "0", "1", "2", "6", "6", "6", "2", "0", "1"],
        ["4", "0", "3", "3", "0", "1", "2", "6", "6", "6", "2", "0", "1"],
        ["4", "0", "5", "2", "2", "2", "2", "1", "6", "1", "2", "0", "6"],
        ["4", "0", "4", "2", "0", "0", "2", "1", "6", "1", "2", "0", "2"],
        ["4", "0", "4", "2", "2", "2", "2", "2", "2", "2", "2", "0", "2"],
        ["4", "0", "4", "2", "1", "1", "2", "1", "6", "1", "2", "0", "3"],
        ["4", "0", "4", "2", "1", "1", "2", "1", "6", "1", "2", "0", "0"],
        ["4", "0", "4", "2", "1", "1", "2", "1", "6", "1", "2", "0", "5"],
        ["4", "0", "4", "2", "1", "1", "2", "1", "6", "1", "2", "0", "4"],
        ["4", "0", "4", "2", "1", "1", "2", "1", "6", "1", "2", "0", "0"],
        ["4", "0", "4", "2", "2", "2", "2", "2", "2", "2", "2", "0", "0"],
        ["4", "0", "5", "2", "0", "0", "0", "0", "0", "0", "0", "0", "0"]
    ],
    "destinations": ["LFPG", "EHAM", "EGCC", "EDDW", "ELLX", "LFBO", "LEBL", "LMEA", "LEBF", "LFTY"],
    "airlines": [["RYR", "EGKK"], ["RYR", "EGKK"], ["RYR", "EGKK"], ["RYR", "EGKK"], ["RYR", "EGKK"], ["EZY", "EGKK"], ["TUI", "EGKK"], ["LXR", "EGKK"], ["FDX", "EGKK"], ["BAW", "EGKK"], ["RAF", "EGKK"], ["EER", "EGKK"], ["FBE", "EGKK"]],
    "aircraft_types": [["A320", "LM"], ["B738", "LM"], ["C152", "L"], ["A19N", "LM"]]
}