{
    "airport": "EGCC",
    "grid": [
        ["0", "0", "0", "5", "3", "2", "1", "6", "6", "1", "1", "1", "1"],
        ["0", "0", "0", "4", "0", "2", "1", "6", "2", "2", "2", "2", "0"],
        ["0", "0", "0", "4", "0", "2", "1", "6", "2", "1", "1", "2", "6"],
        ["0", "0", "0", "4", "3", "2", "1", "6", "2", "1", "1", "2", "2"],
        ["0", "0", "0", "4", "0", "2", "2", "2", "2", "2", "2", "2", "0"],
        ["0", "0", "0", "4", "0", "2", "6", "6", "6", "6", "6", "6", "3"],
        ["0", "0", "0", "4", "0", "2", "6", "1", "1", "1", "1", "6", "6"],
        ["0", "0", "0", "4", "0", "2", "2", "2", "2", "2", "2", "1", "6"],
        ["0", "0", "0", "4", "3", "2", "0", "6", "6", "1", "2", "1", "6"],
        ["0", "0", "0", "4", "0", "2", "0", "6", "6", "1", "2", "1", "6"],
        ["0", "0", "0", "4", "0", "2", "0", "6", "6", "1", "2", "1", "6"],
        ["0", "0", "0", "5", "3", "2", "0", "6", "6", "1", "2", "1", "6"]
    ],
    "destinations": ["LFPG", "EHAM", "EGSS", "EDDW", "ELLX", "LFBO", "LEBL", "LMEA", "LEBF", "LFTY"],
    "airlines": [["RYR", "EGCC"], ["RYR", "EGCC"], ["RYR", "EGCC"], ["RYR", "EGCC"], ["RYR", "EGCC"], ["EZY", "EGCC"], ["TUI", "EGCC"], ["LXR", "EGCC"], ["FDX", "EGCC"], ["BAW", "EGCC"], ["RAF", "EGCC"], ["EER", "EGCC"], ["FBE", "EGCC"]],
    "aircraft_types": [["A320", "LM"], ["B738", "LM"], ["C152", "L"], ["A19N", "LM"]]
}